8
************
*l.......l.*
*.**...*...*
*....*...*.*
*l........**
*....***..+*
*.....l*...*
************
50
red blue gray white red